 6  1  1  7  1  1  0  0  0  0  0  0  0
"E-101               "
"Tzzzz!                                                         "
 0  0  0
 3  12  0  0  50
 6  1  1  4  0  4  1  0  0  0  0  0  0
"E-102               "
"TZêIN!                                                         "
 1  0  0  4  15  1  4  0
-1  1  1  5  1  1  2  0  0  0  0  0  0
"Vocà achou uma sacolacheia de itens!                           "
 1  3  0
"               ","               "
 1  0  2
"          "
 5  25  0  0  0  0  0  0  1  0  0
 3  1  1  4  0  4  1  1  0  0  0  0  0
 0  2  1  6  6  1  0  0
 3  2  1  6  6  3  0  0  0  0  0  0  0
 0  1  1  4  3  0  0  0
 3  1  1  0  6  3  0  0  0  0  0  0  0
 0  0  2  8  1  0  0  0
 3  1  2  0  1  1  0  0  0  0  0  0  0
 0  0  1  8  6  0  0  0
4
 1  1  10  1  1  0  0  0  0  0  0  0
"O Port∆o est† tranca-do!                                       "
 0  0  0
 4
 1  1  11  1  1  0  0  0  0  0  0  0
"O Port∆o est† tranca-do!                                       "
 0  0  0
 5  1  1  14  1  1  3  0  0  0  0  0 -4
"Ronald              "
"E a° cà faz um favor pra eu? Pega l† uma  fita na Flap cara.   "
 1  0  0  5  2
 5  1  1  14  1  1  3  1  0  0  0  0 -4
"Ronald              "
"Vai l† cara!                                                   "
 1  0  0  0   0
 3  1  1  15  0  2  0  0  0  0  0  0  0
 0  4  1  13  4  0  0  0
 3  1  1  14  1  1  0  0  0  0  0  0  4
 0  3  1  6  6  0  0  0
 3  4  1  13  4  1  0  0  0  0  0  0  0
 0  1  1  15  3  0  0  0
 2  4  1  7  6  1  4  0  0  0  0  0  0
"Lanáa          "
 2  9  1  0  0
 6  4  1  7  3  1  5  0  0  0  0  0  0
"E-101               "
"...                                                            "
 1  0  0  3  13  1  6  0
 5  4  1  10  4  1  3  1  0  0  0  0 -4
"Alessandro          "
"Uma fita de 64? S∆o  R$2.00! Beleza?                           "
 2  0  0  5  -2
 1  4  1  10  4  1  3  0  0  0  0  0  0
"Que vocà vai lev†?   "
"Fita 64        "
 4  3  2
"Fita video     "
 4  7  1.5
"DVD            "
 4  8  15
"- - -          "
 0  0  0  0  0  0
 5  4  1  10  4  1  3  2  0  0  0  0  0
"Alessandro          "
"T¢ a sua fita!                                                 "
 3  0  0  4  3
 5  1  1  14  1  1  3  2  0  0  0  0 -4
"Ronald              "
"Cadà a fita???                                                 "
 2  0  0  0    0
 5  1  1  14  1  1  3  3  0  0  0  0 -4
"Ronald              "
"Valeu cara!                                                    "
 4  0  0  0    0
 3  1  1  14  1  1  3  4  0  0  0  0 -4
 0  3  1  6  6  4  0  0
 1  4  1  10  4  1  3  4  0  0  0  0  0
"Que vocà vai lev†?   "
"Fita 64        "
 4  3  2
"Fita video     "
 4  7  1.5
"DVD            "
 4  8  15
"- - -          "
 0  0  0  4  0  0
 1  4  1  10  4  1  3  3  0  0  0  0  0
"Que vocà vai lev†?   "
"Fita 64        "
 4  3  2
"Fita video     "
 4  7  1.5
"DVD            "
 4  8  15
"- - -          "
 0  0  0  3  0  0
 3  3  1  6  6  3  0  0  0  0  0  0  0
 0  1  1  14  1  0  0  0
 3  3  1  7  2  1  0  0  0  0  0  0  0
 0  0  2  6  6  0  0  0
 3  3  2  6  6  3  0  0  0  0  0  0  0
 0  0  1  7  2  0  0  0
 3  3  2  15  2  1  0  0  0  0  0  0  0
 0  0  3  6  3  0  0  0
 3  3  3  6  3  3  0  0  0  0  0  0  0
 0  0  2  15  2  0  0  0
 3  3  1  13  2  1  0  0  0  0  0  0  0
 0  0  3  10  6  0  0  0
 3  3  3  10  6  3  0  0  0  0  0  0  0
 0  0  1  13  2  0  0  0
 2  3  2  11  3  1  6  0  0  0  0  0  0
"Fritas         "
 1  9  1  0  0
 2  3  2  10  3  1  7  0  0  0  0  0  0
"Um l°quido azul"
 1  13  1  0  0

 3  3  3  6  2  1  0  0  0  0  0  0  0
 0  0  4  11  5  0  0  0
 4
 3  3  10  3  1  8  0  0  0  0  0  0
"E o AtlÇtico goleia  o coxa aqui na Arena da Baixada!!!!       "
 1  0  0
 4
 3  3  10  3  1  8  1  0  0  0  0  0
"O juiz aponta para o centro do campo!     ATLêTICO ê CAMPE«O!!!"
 2  0  0
 5  3  3  10  3  1  8  2  0  0  0  0  0
"Galv∆o Bueno        "
"O Rubro-negro merece esse t°tulo! Invicto desde o in°cio!      "
 3  0  0  0    0
 2  3  3  12  3  1  9  0  0  0  0  0  0
"Fita K7        "
 4  7  1  0  0
 3  3  4  11  5  3  0  0  0  0  0  0  0
 0  0  3  6  2  0  0  0
 3  1  2  11  3  2  0  0  0  0  0  0  0
 0  5  1  2  5  0  0  0
 3  5  1  2  0  4  0  0  0  0  0  0  0
 0  1  2  11  3  0  0  0
 3  3  5  6  4  2  0  0  0  0  0  0  0
 0  0  4  4  4  0  0  0
 3  3  4  4  4  4  0  0  0  0  0  0  0
 0  0  5  6  4  0  0  0
 3  3  5  0  6  3  0  0  0  0  0  0  0
 0  0  2  6  2  0  0  0
 3  3  2  6  2  1  0  0  0  0  0  0  0
 0  0  5  4  6  0  0  0
 3  5  2  14  6  3  0  0  0  0  0  0  0
 0  0  1  17  6  0  0  0
 3  5  1  17  6  1  0  0  0  0  0  0  0
 0  0  2  14  6  0  0  0
 3  5  2  8  5  4  0  0  0  0  0  0  0
 0  0  3  17  5  0  0  0
 3  5  3  17  5  2  0  0  0  0  0  0  0
 0  0  2  8  5  0  0  0
 1  2  1  6  3  1  0  0  0  0  0  0  0
"O que deseja?        "
"Mek-Fritas     "
 1  9  1
"Mek-Bacon      "
 1  11  2
"Big-Mek        "
 1  12  4
"Coka-Colla     "
 1  7  1  0  0  0
 6  1  2  0  6  3  12  0  0  0  0  0  0
"Jean                "
"Daqui tu n∆o passa                                             "
 1  0  0  5  25  0  0  0
 4
 1  2  0  6  3  12  1  14  0  0  0  0
"Pra entrar aqui nesselugar maluco precisa de um medalh∆o.      "
 1  0  0
 6  1  2  11  5  2  0  0  0  0  0  0  0
"E-101               "
"...                                                            "
 0  0  0  3  5  0  0  20
 4
 5  3  15  3  1  13  0  0  0  0  0  0
"A porta emperrou! Quedroga!                                    "
 1  0  0
 4
 5  3  15  3  1  13  1  0  0  0  0  0
"Talvez um cacetete dàum jeito nisso.                           "
 1  0  0
 2  5  3  9  4  2  13  1  0  0  0  0  0
"Um cacetete    "
 2  6  2  0  0
 4
 5  3  15  3  1  13  2  0  0  0  0  0
"Delicadamente vocà u-sou o cacetete e des-truiu a porta...     "
 3  0  0
 2  5  3  15  3  1  13  3  14  0  16  0  0
"Chave          "
 3  1  4  1  1
 4
 5  2  8  2  4  14  0  0  0  0  0  0
"Precisa de uma chave pra entrar aqui!                          "
 0  0  0
 3  5  2  8  2  4  16  1  0  0  0  0  0
 0  0  4  16  5  1  0  0
 4
 5  3  6  2  1  14  0  0  0  0  0  0
"Precisa de uma chave pra entrar aqui!                          "
 0  0  0
 3  5  3  6  2  1  16  1  0  0  0  0  0
 0  0  4  4  5  1  0  0
 3  5  4  16  5  2  0  0  0  0  0  0  0
 0  0  2  8  2  0  0  0
 3  5  4  4  6  3  0  0  0  0  0  0  0
 0  0  3  6  2  0  0  0
 3  5  4  15  5  1  0  0  0  0  0  0  0
 0  0  0  15  3  0  0  0
 3  5  4  15  3  3  0  0  0  0  0  0  0
 0  0  0  15  5  0  0  0
 6  5  4  15  3  2  14  1  0  0  0  0  0
"E-101               "
"Vocà nunca conseguir†o medalh∆o! Huahuahua                     "
 2  0  0  3  15  3  2  0
 3  5  4  10  5  1  14  2  0  0  0  0  0
 0  0  0  10  3  2  0  0
 3  5  4  10  3  3  0  0  0  0  0  0  0
 0  0  0  10  5  0  0  0
 4
 5  4  10  5  1  14  1  0  0  0  0  0
"Precisa de uma outra chave para passar poraqui!                "
 1  0  0
 4
 5  4  5  5  1  14  1  0  0  0  0  0
"Precisa de uma outra chave pra passar por aqui!                "
 1  0  0

 4
 5  4  5  5  1  14  2  0  0  0  0  0
"Precisa de uma outra chave para passar poraqui!                "
 2  0  0
 3  5  4  5  5  1  14  3  0  0  0  0  0
 0  0  0  5  3  3  0  0
 3  5  4  5  3  3  0  0  0  0  0  0  0
 0  0  0  5  5  0  0  0
 6  5  4  12  3  1  14  2  0  0  0  0  0
"E-101               "
"Tzzzz¢ein!                                                     "
 3  0  0  3  20  3  3  0
 3  5  4  10  5  1  14  3  0  0  0  0  0
 0  0  0  10  3  3  0  0
 6  5  4  6  2  2  14  3  0  0  0  0  0
"Guardi∆o            "
"Sou o guardi∆o do me-dalh∆o. VOC“ N«O VAI ME VENCEEER!         "
 4  0  0  4  20  4  8  0
 2  5  3  13  3  1  15  0  0  0  0  0  0
"Sandu°che      "
 1  2  1  0  0
 4
 5  4  4  3  1  0  0  0  0  0  0  0
"Harry Potter quebra  todos os recordes de bilheteria!          "
 0  0  0
 4
 3  5  5  2  1  0  0  0  0  0  0  0
"A porta est† trancada                                          "
 0  0  0
 5  3  4  10  3  1  0  0  0  0  0  0  0
"Rodyer              "
"Oeee!                                                          "
 0  0  0  0    0
 3  5  4  5  5  1  14  4  0  0  0  0  0
 0  0  0  5  3  4         0  0
 3  5  4  10  5  1  14  4  0  0  0  0  0
 0  0  0  10  3  4  0  0
 4
 1  2  0  6  3  12  1  14  1  0  0  0
"Precisa de um meda-  lh∆o!                                     "
 1  1  0
 4
 3  1  6  5  1  0  0  0  0  0  0 -3
"                                                               "
 0  0  0
 4
 3  1  6  5  1  0  0  0  0  0  0  3
"Oi!                                                            "
 0  0  0
 2  1  2  6  3  4  17  0  0  0  0  0  0
"Uma arma       "
 2  8  1  0  0

 3  1  2  0  6  3  12  1  14  4  0  0  0
 3  1  1  9  5  0  0  0

