 1  1
 0  0  0  3  1  1  2  1  4  1  7  1  2  1  1  1  0  0  0
 0  0  0  25  25  25  25  25  14  25  17  25  25  25  25  25  0  0  0
 0  0  0  25  25  5  6  25  25  25  25  25  8  9  25  25  0  0  0
 0  0  0  25  25  15  16  25  25  25  25  25  18  19  25  25  0  0  0
 0  0  0  25  25  25  25  25  25  25  25  25  25  25  25  25  0  0  0
 0  0  0  25  0  0  0  0  0  0  0  0  0  0  0  25  0  0  0
 1  2
 0  0  0  3  7  0  0  0  0  0  0  0  0  0  0  0  0  0  0
 0  0  0  24  17  1  1  1  0  0  0  0  0  0  0  0  0  0  0
 0  0  0  24  24  24  24  24  0  0  0  0  0  0  0  0  0  0  0
 0  0  0  24  0  0  0  0  0  0  0  0  0  0  0  0  0  0  0
 0  0  0  24  24  0  0  0  0  0  0  0  0  0  0  0  0  0  0
 0  0  0  24  0  0  0  0  0  0  0  0  0  0  0  0  0  0  0
 1  3
 0  0  0  0  3  1  1  2  1  2  1  1  0  0  0  0  0  0  0
 0  0  0  0  25  25  25  25  25  25  25  25  0  0  0  0  0  0  0
 0  0  0  0  10  25  25  25  25  25  25  11  0  0  0  0  0  0  0
 0  0  1  3  20  25  25  25  25  25  25  12  0  0  0  0  0  0  0
 0  0  25  25  25  25  25  25  25  25  25  25  0  0  0  0  0  0  0
 0  0  0  25  0  0  0  0  0  0  0  0  0  0  0  0  0  0  0
 1  4
 0  0  0  0  25  1  1  1  1  1  1  1  4  1  0  0  0  0  0
 0  0  0  0  25  25  25  25  25  25  26  25  14  25  0  0  0  0  0
 0  0  0  0  3  0  25  25  25  25  25  25  25  25  0  0  0  0  0
 0  0  0  0  0  0  25  25  25  25  25  25  25  25  0  0  0  0  0
 0  0  0  0  0  0  25  21  22  25  25  25  25  25  0  0  0  0  0
 0  0  0  0  0  0  0  0  0  0  0  0  0  0  0  0  0  0  0
 1  5
 0  0  0  3  1  1  1  1  1  1  1  1  0  1  1  0  0  0  0
 0  0  0  25  25  25  25  25  25  25  13  25  0  25  25  0  0  0  0
 0  0  0  4  25  25  25  25  25  25  32  25  0  25  25  0  0  0  0
 0  0  0  14  25  25  25  25  25  25  25  25  1  25  25  0  0  0  0
 0  0  0  25  25  21  22  25  25  25  25  25  25  25  25  0  0  0  0
 0  0  0  0  0  0  0  0  0  0  0  0  0  0  0  0  0  0  0
 1  6
 0  0  0  0  0  1  1  1  1  1  1  0  0  0  0  0  0  0  0
 0  0  0  0  0  4  25  28  25  25  29  0  0  0  0  0  0  0  0
 0  0  0  0  0  14  25  25  25  25  15  1  3  1  0  0  0  0  0
 0  0  0  0  0  25  25  25  25  25  25  25  25  25  0  0  0  0  0
 0  0  0  0  0  25  25  25  25  25  25  25  25  25  0  0  0  0  0
 0  0  0  0  0  25  25  25  25  25  25  25  21  22  0  0  0  0  0
 1  7
 0  0  0  1  1  1  1  1  1  1  1  1  1  1  0  0  0  0  0
 0  0  0  24  24  24  24  24  24  24  24  24  24  24  0  0  0  0  0
 0  0  0  0  0  0  0  0  4  24  24  24  24  24  0  0  0  0  0
 0  0  0  0  0  0  0  0  14  24  24  24  24  24  0  0  0  0  0
 0  0  0  0  0  0  0  0  24  24  24  24  24  24  0  0  0  0  0
 0  0  0  0  0  0  0  0  0  0  0  0  0  24  0  0  0  0  0
 2  1
 0  0  0  0  0  1  1  1  1  3  1  1  1  0  0  0  0  0  0
 0  0  0  0  0  23  23  23  23  23  23  23  23  0  0  0  0  0  0
 0  0  0  0  0  0  23  23  23  23  23  23  0  0  0  0  0  0  0
 0  0  0  0  0  23  23  23  23  23  23  23  23  0  0  0  0  0  0
 0  0  0  0  0  0  23  23  23  23  23  23  0  0  0  0  0  0  0
 0  0  0  0  0  23  23  23  23  23  23  23  23  0  0  0  0  0  0
 2  2
 0  0  0  0  0  0  23  23  23  23  23  23  0  0  0  0  0  0  0
 0  0  0  0  0  23  23  23  23  23  23  23  23  0  0  0  0  0  0
 0  0  0  0  0  0  23  23  23  23  23  23  0  0  0  0  0  0  0
 0  0  0  0  0  23  23  23  23  23  23  23  23  0  0  0  0  0  0
 0  0  0  0  0  0  23  23  23  23  23  23  0  0  0  0  0  0  0
 0  0  0  0  0  23  23  23  23  23  23  23  23  0  0  0  0  0  0
 3  1
 0  0  0  1  1  1  1  1  1  1  1  1  1  1  0  0  0  0  0
 0  0  0  24  24  24  24  24  24  24  24  24  24  24  0  0  0  0  0
 0  0  0  0  24  24  24  24  24  24  24  0  0  0  0  0  0  0  0
 0  0  0  0  24  24  24  24  0  24  0  0  0  0  0  0  0  0  0
 0  0  0  0  24  24  24  24  0  0  0  0  0  0  0  0  0  0  0
 0  0  0  0  24  24  24  24  0  0  0  0  0  0  0  0  0  0  0
 3  2
 0  0  0  0  3  1  1  1  1  1  1  3  0  0  0  0  0  0  0
 0  0  0  0  25  25  25  25  25  25  25  25  0  0  0  0  0  0  0
 0  0  0  0  25  5  6  25  25  25  25  11 0  0  0  0  0  0  0
 0  0  0  0  25  15  16  25  25  25  25  12  0  0  0  0  0  0  0
 0  0  0  0  25  25  25  25  25  25  25  25  25  0  0  0  0  0  0
 0  0  0  0  25  0  0  0  0  0  0  0  0  0  0  0  0  0  0
 3  3
 0  0  0  0  1  1  1  1  1  1  1  1  0  0  0  0  0  0  0
 0  0  0  0  25  25  25  25  25  25  13  25  0  0  0  0  0  0  0
 0  0  0  0  0  0  25  25  25  25  25  25  0  0  0  0  0  0  0
 0  0  0  0  0  0  41  25  25  25  21  22  0  0  0  0  0  0  0
 0  0  0  0  0  0  25  25  25  25  25  25  0  0  0  0  0  0  0
 0  0  0  0  0  0  0  0  0  0  0  0  0  0  0  0  0  0  0
 3  4
 0  0  0  0  0  0  0  0  0  0  0  0  0  0  0  0  0  0  0
 0  0  0  0  3  1  1  1  1  7  1  0  0  0  0  0  0  0  0
 0  0  0  0  25  25  25  25  25  17  25  0  0  0  0  0  0  0  0
 0  0  0  0  8  9  25  25  25  25  25  0  0  0  0  0  0  0  0
 0  0  0  0  18  19  25  5  6  25  25  0  0  0  0  0  0  0  0
 0  0  0  0  25  25  25  15  16  25  25  0  0  0  0  0  0  0  0
 4  1
 0  0  0  0  0  1  1  1  1  1  0  0  0  0  0  0  0  0  0
 0  0  0  0  0  25  25  25  25  25  0  0  0  0  0  0  0  0  0
 0  0  0  0  0  25  25  27  25  25  0  0  0  0  0  0  0  0  0
 0  0  0  0  0  25  25  25  25  25  0  0  0  0  0  0  0  0  0
 0  0  0  0  0  25  25  25  25  25  0  0  0  0  0  0  0  0  0
 0  0  0  0  0  25  25  25  25  25  0  0  0  0  0  0  0  0  0

