 1  1
 0  0  0  0  23  0  23  0  0  23  23  0  0  23  0  0  0  0  0
 0  0  0  23  23  23  23  23  23  23  23  23  23  23  23  0  0  0  0
 0  0  0  23  23  23  23  23  23  23  23  23  23  23  23  0  0  0  0
 0  0  0  23  23  23  23  23  23  23  23  23  23  23  23  0  0  0  0
 0  0  0  0  0  0  23  23  23  23  0  0  0  0  0  0  0  0  0
 0  0  0  0  0  0  23  23  23  23  0  0  0  0  0  0  0  0  0
 1  2
 0  0  0  0  0  0  23  23  23  23  0  0  0  0  0  0  0  0  0
 0  0  0  0  0  0  23  23  23  23  0  0  0  0  0  0  0  0  0
 0  0  0  0  0  23  23  23  23  23  23  0  0  0  0  0  0  0  0
 0  0  0  0  0  0  23  23  23  23  0  0  0  0  0  0  0  0  0
 0  0  0  0  0  23  23  23  23  23  23  0  0  0  0  0  0  0  0
 0  0  0  0  0  0  23  23  23  23  0  0  0  0  0  0  0  0  0
 2  1
 0  0  0  0  0  1  1  1  1  1  7  1  7  1  0  0  0  0  0
 0  0  0  0  0  26  13  25  25  25  17  25  17  25  0  0  0  0  0
 0  0  0  0  0  25  25  25  25  25  25  25  25  25  0  0  0  0  0
 0  0  0  0  0  25  25  25  25  25  25  25  25  25  0  0  0  0  0
 0  0  0  0  0  25  25  25  25  25  25  25  25  25  0  0  0  0  0
 0  0  0  0  0  23  0  0  0  0  0  0  0  0  0  0  0  0  0
 3  1
 0  0  0  0  1  1  3  1  1  1  1  1  3  1  0  0  0  0  0
 0  0  0  0  24  24  24  24  24  24  24  24  24  24  0  0  0  0  0
 0  0  0  0  24  24  24  24  0  24  24  24  24  24  0  0  0  0  0
 0  0  0  0  24  51  24  24  0  24  24  24  24  24  0  0  0  0  0
 0  0  0  0  24  24  24  24  0  24  24  24  24  24  0  0  0  0  0
 0  0  0  0  0   24  0   0   0  0   0   0   0   0   0  0  0  0  0
 4  1
 0  0  0  0  0  3  4  1  1  1  1  0  0  0  0  0  0  0  0
 0  0  0  0  0  25  14  25  25  13  25  0  0  0  0  0  0  0  0
 0  0  0  0  0  25  25  25  25  27  25  1  3  0  0  0  0  0  0
 0  0  0  0  0  25  4  25  25  25  25  25  25  0  0  0  0  0  0
 0  0  0  0  0  25  14  25  25  25  25  25  25  0  0  0  0  0  0
 0  0  0  0  0  25  25  25  25  25  25  25  25  0  0  0  0  0  0
 3  2
 0  0  0  0  1  3  1  1  0  7  4  1  1  1  3  1  0  0  0
 0  0  0  0  24  24  24  24  0  17  14  25  8  9  25  25  0  0  0
 0  0  0  0  24  24  24  24  1  25  25  25  18  19  25  25  0  0  0
 0  0  0  0  24  24  24  24  25  25  25  25  25  25  25  25  0  0  0
 0  0  0  0  24  24  24  24  0  25  25  25  25  25  25  25  0  0  0
 0  0  0  0  0  24  0  0  0  0  0  0  0  0  0  0  0  0  0
 3  3
 0  0  0  0  0  3  1  1  1  29  1  4  0  0  0  0  0  0  0
 0  0  0  0  0  25  25  25  25  14  25  14  0  0  0  0  0  0  0
 0  0  0  0  0  25  0  25  25  25  25  25  0  0  0  0  0  0  0
 0  0  0  0  0  0  0  10  25  25  25  11  0  0  0  0  0  0  0
 0  0  0  0  0  0  0  20  25  25  25  12  0  0  0  0  0  0  0
 0  0  0  0  0  0  0  0  0  24  0  0  0  0  0  0  0  0  0
 3  4
 0  0  0  0  1  1  1  2  1  1  1  0  0  0  0  0  0  0  0
 0  0  0  0  21  22  25  25  25  27  25  0  0  0  0  0  0  0  0
 0  0  0  0  25  25  25  25  25  25  25  0  0  0  0  0  0  0  0
 0  0  0  24  25  25  25  25  25  25  25  0  0  0  0  0  0  0  0
 0  0  0  0  25  25  25  0  0  0  25  0  0  0  0  0  0  0  0
 0  0  0  0  0  0  0  0  0  0  0  0  0  0  0  0  0  0  0
 5  1
 0  0  0  0  0  0  0  0  0  0  0  0  0  0  0  0  0  0  0
 0  0  0  0  0  0  0  0  0  0  0  0  0  0  0  0  0  0  0
 0  24  24  24  24  24  24  24  0  0  0  0  0  0  0  0  0  0  0
 0  24  24  24  24  24  24  24  0  0  0  0  0  0  0  0  0  0  0
 0  24  24  24  24  24  24  24  1  1  1  1  1  1  1  1  3  0  0
 0  24  24  24  24  24  24  24  24  24  24  24  24  24  24  24  24  0  0
 3  5
 0  0  0  1  3  0  0  0  0  0  0  0  0  0  0  0  0  0  0
 0  0  0  24  24  0  0  0  0  0  0  0  0  0  0  0  0  0  0
 0  0  0  24  24  0  0  0  0  0  0  0  0  0  0  0  0  0  0
 0  0  0  24  24  25  0  0  0  0  0  0  0  0  0  0  0  0  0
 0  0  0  24  24  0  0  0  0  0  0  0  0  0  0  0  0  0  0
 0  0  0  24  24  0  0  0  0  0  0  0  0  0  0  0  0  0  0
 5  2
 0  0  0  0  0  0  0  1  1  1  1  1  1  1  0  0  0  0  0
 0  0  0  0  0  0  0  25  25  25  25  25  25  25  0  0  0  0  0
 0  0  0  0  0  0  0  0  25  25  25  25  25  25  0  0  0  0  0
 0  0  0  0  0  0  0  0  25  25  25  25  25  25  0  0  0  0  0
 0  0  0  0  0  0  0  25  25  25  25  25  25  25  0  0  0  0  0
 0  0  0  0  0  0  0  0  0  0  0  0  0  24  0  0  0  0  0
 5  3
 0  0  0  0  0  3  1  1  1  1  0  1  4  1  7  1  0  0  0
 0  0  0  0  0  25  25  25  25  25  0  25  14  25  17  25  0  0  0
 0  0  0  0  0  25  25  25  25  11  0  25  25  25  25  25  0  0  0
 0  0  0  0  0  25  25  25  25  12  1  25  25  25  25  25  0  0  0
 0  0  0  0  0  25  25  25  25  25  25  25  25  25  25  25  25  0  0
 0  0  0  0  0  0  0  0  0  0  0  0  0  0  0  0  0  0  0
 5  4
 0  0  0  29  1  2  1  0  1  1  2  1  0  1  2  1  0  0  0
 0  0  0  14  25  25  30  0  25  25  21  22  0  25  25  11  0  0  0
 0  0  0  25  25  21  22  0  25  25  25  25  0  25  25  12  0  0  0
 0  0  0  1  3  1  1  1  1  3  1  1  1  1  3  1  0  0  0
 0  0  0  25  25  25  25  25  25  25  25  25  25  25  25  25  0  0  0
 0  0  0  25 0  0  0  0  0  0  0  0  0  0  0  0  0  0  0

