 1  1
 0  0  0  0  0  0  1  1  2  1  1  0  0  0  0  0  0  0  0
 0  0  0  0  0  0  24  24  24  24  24  0  0  0  0  0  0  0  0
 0  0  0  0  0  0  24  24  24  24  24  0  0  0  0  0  0  0  0
 0  0  0  0  0  0  24  24  24  24  24  0  0  0  0  0  0  0  0
 0  0  0  0  0  0  24  24  24  24  24  0  0  0  0  0  0  0  0
 0  0  0  0  0  0  0  0  0  0  0  0  0  0  0  0  0  0  0
 1  2
 0  0  0  0  1  1  1  30  1  2  1  30  1  1  1  0  0  0  0
 0  0  0  0  25  25  25  14  25  25  25  14  25  25  25  0  0  0  0
 0  0  0  0  10  25  25  25  25  25  25  25  25  25  11  0  0  0  0
 0  0  0  0  20  25  25  25  25  25  25  25  25  25  12  0  0  0  0
 0  0  0  0  25  25  25  25  25  25  25  25  25  25  25  0  0  0  0
 0  0  0  0  0  0  0  0  0  0  0  0  0  0  0  0  0  0  0
 1  3
 0  0  0  0  1  2  1  4  1  3  1  4  1  2  1  0  0  0  0
 0  0  0  0  25  25  25  14  25  25  25  14  25  25  25  0  0  0  0
 0  0  0  0  25  25  25  25  25  25  25  25  25  25  25  0  0  0  0
 0  0  0  0  25  25  25  25  25  25  25  25  25  25  25  0  0  0  0
 0  0  0  0  25  25  25  25  25  25  25  25  25  25  25  0  0  0  0
 0  0  0  0  0  0  0  0  0  0  0  0  0  0  0  0  0  0  0
 1  4
 0  0  1  1  1  1  1  1  4  0  1  2  1  1  1  1  2  1  0
 0  0  25  13  25  13  25  13  14  0  25  25  25  25  25  25  25  25  0
 0  0  25  25  25  25  25  25  25  0  10  25  25  29  6  25  25  11  0
 0  0  1  1  1  2  1  1  1  0  20  25  25  15  16  25  25  12  0
 0  0  25  25  25  25  25  25  25  25  25  25  25  25  25  25  25  25  0
 0  0  0  0  0  0  0  0  0  0  0  0  0  0  0  0  0  25  0
 1  5
 0  0  0  0  0  0  0  0  0  0  1  30  1  1  0  1  4  1  0
 0  0  0  0  0  0  0  0  0  0  25  14  25  25  0  25  14  25  0
 0  0  0  0  0  0  0  0  0  0  25  25  25  11  0  25  25  25  0
 0  0  0  0  0  0  0  0  0  0  25  5  25  12  0  25  25  25  0
 0  0  0  0  0  0  0  0  0  0  25  25  25  25  0  25  25  25  0
 0  0  0  0  0  0  0  0  0  0  0  25  0  0  0  0  25  0  0

 1  6
 0  1  1  1  1  0  1  1  1  4  1  1  1  0  1  1  2  1  0
 0  25  25  25  25  0  25  25  25  14  25  25  25  0  25  25  25  25  0
 0  25  29  6  25  0  25  5  25  25  25  5  25  0  25  8  9  25  0
 0  25  15  16  25  1  1  1  1  2  1  1  1  1  25  18  19  25  0
 0  25  25  25  25  25  25  25  25  25  25  25  25  25  25  25  25  25  0
 0  25  0  0  0  0  0  0  0  0  0  0  0  0  0  0  0  0  0
 1  7
 0  1  1  30  1  0  1  1  1  4  1  1  1  0  1  30  1  1  0
 0  23  23  21  23  0  25  13  25  14  25  13  25  0  25  14  25  25  0
 0  23  23  23  23  0  25  25  25  25  25  25  25  0  25  25  25  11  0
 0  23  23  23  23  0  25  25  13  25  13  25  25  0  5  25  26  12  0
 0  23  23  23  23  0  25  25  25  25  25  25  25  0  25  25  25  25  0
 0  0  0  0  0  0  0  0  0  25  0  0  0  0  0  0  25  0  0
 2  1
 0  0  0  0  1  1  1  30  1  2  1  30  1  1  1  0  0  0  0
 0  0  0  0  23  23  23  21  23  23  23  21  23  23  23  0  0  0  0
 0  0  0  0  23  23  23  23  23  23  23  23  23  23  23  23  0  0  0
 0  0  0  0  23  23  23  23  23  23  23  23  23  23  23  0  0  0  0
 0  0  0  0  23  23  23  23  23  23  23  23  23  23  23  0  0  0  0
 0  0  0  0  0  0  0  0  0  23  0  0  0  0  0  0  0  0  0
 2  2
 0  0  0  0  1  2  1  4  1  3  1  4  1  2  1  0  0  0  0
 0  0  0  0  23  23  23  21  23  23  23  21  23  23  23  0  0  0  0
 0  0  0  0  23  23  23  23  23  23  23  23  23  23  23  0  0  0  0
 0  0  0  0  23  23  23  23  23  23  23  23  23  23  23  0  0  0  0
 0  0  0  0  23  23  23  23  23  23  23  23  23  23  23  0  0  0  0
 0  0  0  0  0  0  0  0  0  23  0  0  0  0  0  0  0  0  0
 2  3
 0  1  1  1  0  30  1  1  1  4  1  0  1  4  1  1  1  1  0
 0  25  25  25  0  14  25  5  25  14  25  0  25  14  25  25  25  25  0
 0  27  25  11  0  25  25  25  25  25  25  0  25  25  25  29  6  25  0
 0  25  25  12  1  25  5  25  25  5  25  1  25  25  25  15  16  25  0
 0  25  25  25  25  25  25  25  25  25  25  25  25  25  25  25  25  25  0
 0  0  0  0  0  0  0  0  0  0  0  0  0  0  0  0  0  25  0

 2  4
 0  1  1  1  1  0  1  1  1  4  1  2  1  1  30  1  1  1  0
 0  25  25  25  25  0  22  25  25  14  25  25  25  25  14  25  25  11  0
 0  25  29  6  25  0  25  25  25  25  25  25  25  25  25  25  25  12  0
 0  25  15  16  25  1  1  1  1  1  1  2  1  1  1  1  1  1  0
 0  25  25  25  25  25  25  25  25  25  25  25  25  25  25  25  25  25  0
 0  25  0  0  0  0  0  0  0  0  0  0  0  0  0  0  0  0  0
 2  5
 0  0  0  0  0  0  0  0  1  4  1  30  1  4  1  0  0  0  0
 0  0  0  0  0  0  0  0  25  14  25  14  25  14  25  0  0  0  0
 0  0  0  0  0  0  0  0  25  25  25  25  25  25  25  0  0  0  0
 0  0  0  0  0  0  0  0  10  25  25  13  25  25  11  0  0  0  0
 0  0  0  0  0  0  0  0  20  25  25  25  25  25  12  0  0  0  0
 0  0  0  0  0  0  0  0  0  0  0  25  0  0  0  0  0  0  0
 2  6
 0  0  0  0  0  0  1  30  1  3  1  30  1  0  0  0  0  0  0
 0  0  0  0  0  0  23  14  23  23  23  14  23  0  0  0  0  0  0
 0  0  0  0  0  0  23  23  23  23  23  23  23  0  0  0  0  0  0
 0  0  0  0  0  0  23  23  23  23  23  23  23  0  0  0  0  0  0
 0  0  0  0  0  0  23  23  23  23  23  23  23  0  0  0  0  0  0
 0  0  0  0  0  0  0  0  0  0  0  0  0  0  0  0  0  0  0
 2  7
 0  1  1  4  1  1  30  1  1  1  1  1  30  1  1  4  1  1  0
 0  23  23  21  23  23  21  23  23  28  23  23  21  23  23  21  23  23  0
 0  10  23  23  23  23  23  23  23  23  23  23  23  23  23  23  23  11  0
 0  20  23  23  13  23  23  23  23  23  23  23  23  23  13  23  23  12  0
 0  23  23  23  23  23  23  23  23  23  23  23  23  23  23  23  23  23  0
 0  0  0  0  0  0  0  0  0  0  0  0  0  0  0  0  0  0  0

